Aa^Fpa, Aa^Fpa, Aa^Fpa, Aa^Fpa, Aa^Fpa, Aa^Fpa, Aa^Fpa, Aa^Fpa, Aa^Fpa, Aa^Fpa, Ha, Ha, Ha, Ha, Ha, Aa^Fpa, Ha, Ha, Ha, Ha, Ha, Aa, Ha, Aa, Aa, Aa^Fpa, Aa^Fpa, Aa, Aa^Fpa, Aa^Fpa, Aa, Aa, Aa, Aa, Aa, Aa, Aa, Aa, Ai, Ai, Ai, Ai, Ai, Aa, Aa, Aa, Aa, Aa, Aa, Aa, Aa, Aa, Aa, Aa, Aa, Aa, Aa, Aa, Re, Aa, Aa, Aa
Aa^Fpa, Aa^Fpa, Aa^Fpa, Aa^Fpa, Aa^Fpa, Aa^Fpa, Aa^Fpa, Aa^Fpa, Aa^Fpa, Aa^Fpa, Aa^Fpa, Ha, Ha^Fpa, Ha^Fpa, Ha, Ha^Fpa, Ha, Ha, Ha^Fpa, Ha, Ha, Ha, Ha^Fpa, Ha, Ha^Fpa, Aa^Fpa, Aa^Fpa, Aa^Fpa, Aa^Fpa, Aa^Fpa, Aa, Aa, Aa, Aa, Aa, Aa, Aa, Ai, Ai, Ai, Aa^Fpa, Ai, Ai, Aa, Aa^Voa, Aa, Aa, Aa, Aa, Aa, Aa, Aa, Aa, Aa, Aa, Aa, Aa, Re, Aa, Aa, Aa, Aa
Aa^Fpa, Aa^Fpa, Aa^Fpa, Aa^Fpa, Aa^Fpa, Aa^Fpa, Aa, Aa^Fpa, Aa^Fpa, Aa^Fpa, Aa^Fpa, Aa^Fpa, Aa, Aa, Aa^Fpa, Aa^Fpa, Aa, Aa^Fpa, Ha, Ha^Fpa, Ha, Ha, Ha, Ha^Fpa, Ha, Aa^Fpa, Aa, Aa^Fpa, Aa, Aa, Aa, Aa, Aa, Aa, Ai, Ai, Ai, Ai, Aa^Voa, Aa^Fpa, Aa, Ai, Ai, Ai, Ai, Ai, Aa, Aa, Aa, Aa, Aa, Aa, Aa, Aa, Aa, Aa, Aa^Voa, Re, Aa, Aa, Aa, Aa
Aa^Fpa, Aa^Fpa, Aa^Fpa, Aa^Fpa, Aa, Aa, Aa, Aa, Aa, Aa, Aa, Aa, Aa, Aa^Fpa, Aa^Fpa, Aa, Aa^Fpa, Aa, Aa, Aa, Aa, Aa, Aa, Ha, Ha, Aa, Aa, Aa^Voa, Aa, Aa, Aa, Aa, Aa, Aa, Aa, Ai, Ai, Ai, Aa^Fpa, Aa^Fpa, Ai, Ai, Ai, Ai, Aa, Aa, Aa, Aa, Aa, Aa, Aa, Aa, Aa, Aa, Ce, Aa, Re, Re, Aa, Aa, Aa, Aa^Fpa
Aa^Fpa, Aa^Fpa, Aa^Fpa, Aa^Fpa, Aa, Aa, Aa, Aa, Aa, Aa, Aa, Aa, Aa, Aa^Fpa, Aa, Aa, Aa, Aa, Aa, Aa, Aa, Aa, Rd, Aa, Aa, Ha, Aa, Aa, Aa, Aa, Aa^Fpa, Aa, Aa, Aa, Ai, Ai, Ai, Ai, Ai, Aa, Ai, Ai, Aa, Aa, Aa, Aa, Aa, Aa, Rd, Rd, Rd, Aa, Re, Re, Ce, 1 Ke, Ce, Aa, Aa, Aa, Aa^Fpa, Aa^Fpa
Aa^Fpa, Aa^Fpa, Aa^Fpa, Aa^Fpa, Aa, Aa, Aa, Aa, Aa, Aa, Aa, Aa, Aa, Aa, Aa, Aa, Aa, Aa, Rd, Rd, Rd, Rd, Chr, Rd, Rd, Aa, Aa, Aa, Aa^Fpa, Aa^Fpa, Aa^Fpa, Aa, Rd, Aa, Aa, Ai, Ai, Ai, Ai, Ai, Ai, Ai, Aa, Aa, Aa, Aa, Aa, Rd, Aa, Aa, Aa, Aa, Aa, Ce, Ce, Ce, Rd, Aa, Aa, Aa, Aa^Fpa, Aa^Fpa
Aa^Fpa, Aa^Fpa, Aa^Fpa, Aa, Aa^Fpa, Aa, Aa, Aa, Aa, Aa, Aa, Aa, Aa, Aa, Aa, Aa, Rd, Rd, Aa, Aa, Rd, Chr, 2 Khr, Chr, Chr, Rd, Rd, Aa, Aa, Aa^Fpa, Rd, Rd, Aa, Rd, Rd, Aa, Aa, Aa, Aa, Aa, Aa, Aa, Aa, Aa, Rd, Aa, Rd, Rd, Aa, Aa, Aa, Aa, Aa, Aa, Re, Ce, Aa, Rd, Aa, Aa, Aa, Aa^Fpa
Aa^Fpa, Aa^Fpa, Aa^Fpa, Aa^Fpa, Aa^Fpa, Aa, Aa, Aa, Aa, Aa, Aa, Aa, Aa, Aa^Fpa, Aa^Fpa, Rd, Aa, Aa, Aa, Aa, Rd, Chr, Aa, Chr, Ha, Aa, Aa, Rd, Rd, Rd, Aa, Aa, Aa, Aa, Rd, Aa, Rd, Rd, Rd, Rd, Rd, Aa, Rd, Rd, Aa, Rd, Aa, Aa, Aa^Fpa, Aa, Aa^Fpa, Aa, Aa, Aa, Aa, Aa, Aa, Rd, Aa, Aa, Aa^Fpa, Aa^Fpa
Aa^Fpa, Aa^Fpa, Aa^Fpa, Aa, Aa, Aa, Aa, Aa, Aa, Aa, Aa, Aa, Aa, Aa^Fpa, Aa, Rd, Aa, Ha, Ha, Aa, Aa, Rd, Rd, Aa, Aa, Ha^Voa, Ha, Aa, Aa, Aa, Aa, Aa, Aa, Aa, Aa, Rd, Aa, Aa, Aa, Aa, Aa, Rd, Aa, Aa, Aa, Aa, Aa, Aa, Aa, Aa, Ha, Aa^Fpa, Ha^Fpa, Aa^Fpa, Aa^Fpa, Aa, Aa, Rd, Aa, Aa, Aa^Fpa, Aa^Fpa
Aa^Fpa, Aa^Fpa, Aa, Aa^Voa, Aa, Aa, Aa, Aa^Fpa, Aa^Fpa, Aa, Aa, Aa, Aa, Aa, Aa, Rd, Aa, Ha, Ha, Ha, Ha, Aa, Aa, Rd, Aa, Ha, Ha, Ha, Ha, Ha, Aa, Aa, Ha, Ha, Ha, Rd, Ha, Ha, Ha^Voa, Aa, Ha, Aa, Ha, Aa, Aa, Aa, Aa, Aa, Aa, Aa, Ha, Ha, Ha^Fpa, Ha^Fpa, Aa^Fpa, Aa^Fpa, Aa, Rd, Aa, Aa, Aa^Fpa, Aa^Fpa
Aa^Fpa, Aa^Fpa, Aa^Fpa, Aa, Aa, Aa, Aa, Aa^Fpa, Aa, Aa, Aa, Aa, Aa, Aa, Aa, Rd, Aa, Ha, Ha, Ha, Ha, Ha, Aa, Rd, Aa, Aa, Aa, Ha, Ha, Ha, Ha, Ha, Ha, Aa, Aa, Rd, Rd, Ha, Aa, Aa, Aa, Ha, Aa, Aa, Aa, Aa, Aa, Aa, Aa, Aa, Aa, Aa, Aa, Aa, Aa, Aa^Fpa, Aa, Rd, Aa, Aa, Aa, Aa^Fpa
Aa^Fpa, Aa^Fpa, Aa^Fpa, Aa^Fpa, Aa, Aa, Aa, Aa, Aa, Aa, Aa, Aa, Aa, Aa, Rd, Rd, Ha, Ha, Ha^Fpa, Ha^Vca, Ha, Aa, Aa, Rd, Aa, Aa, Ha, Ha, Ha, Aa, Aa, Ha, Ha, Ha, Ha, Ha, Rd, Ha, Aa, Aa, Aa, Aa, Ms, Aa, Aa, Aa, Rd, Aa, Aa, Aa, Aa, Aa, Aa, Aa, Aa, Aa^Fpa, Aa, Rd, Aa, Aa^Fpa, Aa^Fpa, Aa^Fpa
Aa^Fpa, Aa^Fpa, Aa^Fpa, Aa, Aa, Aa, Aa, Aa, Rd, Rd, Rd, Rd, Rd, Rd, Aa, Aa, Ha, Ha^Fpa, Ha^Fpa, Ha, Ha, Aa, Rd, Rd, Rd, Aa, Ha, Ha, Aa, Aa, Aa, Ha, Ha, Ha, Rd, Rd, Aa, Ha, Ha, Aa, Aa, Aa, Ms, Ms, Ms, Aa, Rd, Aa, Aa, Aa^Vca, Aa, Aa, Aa, Aa, Aa, Aa, Aa, Rd, Aa, Aa^Fpa, Aa^Fpa, Aa^Fpa
Aa, Aa^Fpa, Aa, Aa, Aa, Aa, Rd, Rd, Aa, Aa, Aa, Aa, Aa, Aa, Aa, Ha, Ha^Fpa, Ha^Fpa, Ha, Ha, Rd, Ha, Ha, Aa, Ha, Rd, Rd, Aa, Rd, Rd, Rd, Aa, Aa, Ha, Rd, Ha, Ha, Ha, Ha, Ha, Ha, Ha, Aa, Ms, Ms, Aa, Aa, Rd, Aa, Aa, Aa, Aa, Aa, Aa, Aa, Aa, Aa, Rd, Aa, Aa^Fpa, Aa, Aa^Fpa
Aa, Aa, Aa, Aa, Rd, Rd, Aa, Rd, Rd, Aa, Cha, Aa, Aa, Aa, Ha, Ha, Ha^Fpa, Ha^Fpa, Ha, Aa, Rd, Aa, Ha, Ha, Ha, Ha, Aa^Fpa, Rd, Aa, Aa, Aa, Rd, Rd, Rd, Ha, Ha, Ha^Voa, Ha, Aa, Aa, Aa, Aa, Aa, Aa, Aa, Ms, Aa, Rd, Aa, Aa, Aa, Aa, Aa, Aa, Aa, Aa, Rd, Rd, Aa, Aa, Aa, Aa
Aa^Fpa, Aa^Fpa, Aa, Rd, Aa, Aa, Aa, Aa, Aa, Cha, 3 Kha, Cha, Aa, Ha, Ha^Voa, Ha, Ha, Ha, Ha, Ha, Ha, Ha, Ha, Ha, Ha^Fpa, Ha, Ha^Fpa, Aa^Fpa, Aa^Fpa, Ha, Ha, Aa, Rd, Ha, Aa, Aa, Ai, Aa, Ms, Ms, Ms, Aa, Aa, Aa, Aa, Ms, Rd, Rd, Aa, Aa, Aa, Aa, Aa, Aa, Rd, Rd, Aa, Aa, Aa^Fpa, Aa^Voa, Aa^Fpa, Aa^Fpa
Aa^Fpa, Aa^Fpa, Aa^Fpa, Rd, Aa, Aa, Aa, Aa, Aa, Cha, Cha, Cha, Aa, Ha, Aa, Aa, Rd, Aa, Rd, Rd, Aa, Ha, Ha, Ha^Fpa, Ha^Fpa, Ha^Fpa, Ha, Aa^Fpa, Rd, Ha, Aa, Aa, Ai^Bw|, Aa, Ai, Ai, Ww, Ai, Ai, Ai, Ms, Ms, Ms, Aa, Ms, Ms, Rd, Ms, Ms, Aa, Aa, Aa, Aa^Fpa, Aa^Fpa, Rd, Aa, Aa, Aa, Ms, Ms, Ms, Aa^Fpa
Aa^Fpa, Aa^Fpa, Rd, Rd, Aa, Aa, Aa, Aa, Aa, Aa, Aa, Rd, Rd, Aa, Rd, Rd, Aa^Fpa, Rd, Aa, Aa, Aa^Fpa, Ha, Ha, Ha, Ha, Ha, Rd, Rd, Aa, Aa, Ai, Ai, Ww, Ai, Ww, Ww, Ww, Ww, Ww, Ww, Ai, Ms, Ms, Ms, Ms, Ms, Ms, Ms, Ms, Ms, Ms, Aa, Ms, Aa^Fpa, Ms, Ha, Ms, Ms, Ms, Ms, Ms, Ms
Rd, Rd, Aa, Aa, Aa, Aa, Aa, Aa, Aa^Fpa, Aa, Aa^Fpa, Aa, Aa^Fpa, Rd, Aa^Fpa, Aa^Fpa, Ha^Fpa, Aa^Fpa, Ha^Fpa, Aa^Fpa, Ha, Ha, Ha, Ha, Aa, Ha, Rd, Ha, Aa, Ai, Ai, Ww, Ww, Ww, Ww, Ww, Ww, Ww, Ai, Ww, Ai, Ms, Aa^Fpa, Aa^Fpa, Aa^Fpa, Ha^Fpa, Aa, Ms, Aa^Fpa, Ms, Ms, Ms, Ms, Ms, Ms, Ms, Ms, Ms, Ms, Ms, Ms, Ms
Aa, Rd, Rd, Aa, Aa, Aa, Aa^Fpa, Aa^Fpa, Aa^Fpa, Aa^Fpa, Aa, Aa^Fpa, Aa^Fpa, Rd, Rd, Aa^Fpa, Ha^Fpa, Ha, Ha^Fpa, Ha, Aa, Ha, Ha, Ha, Aa, Ha, Ha^Voa, Rd, Aa, Ai, Ww, Ww, Ww, Ww, Ww, Ai, Ai, Ai^Bw\, Rd, Ai, Ms, Ms, Rd, Aa, Rd, Aa^Fpa, Aa, Ha^Fpa, Aa^Fpa, Aa^Fpa, Ms, Ms, Ms, Ms, Ms, Ms, Ms, Ms, Ms, Ms, Ms, Ms
Aa^Fpa, Aa^Fpa, Aa^Fpa, Rd, Rd, Aa^Fpa, Aa^Voa, Aa^Fpa, Aa^Fpa, Aa^Fpa, Aa^Fpa, Aa^Fpa, Aa^Fpa, Aa^Fpa, Rd, Aa^Fpa, Aa^Fpa, Ha^Fpa, Aa, Aa, Ha, Ha, Ha, Aa, Ha, Ha, Aa, Rd, Aa, Ai, Ai, Ai, Ww, Ww, Ai, Ai, Ms, Ms, Rd, Aa, Rd, Rd, Ha^Fpa, Rd, Ha^Fpa, Ha^Fpa, Ha^Fpa, Aa^Fpa, Ms, Ms, Ms, Ms, Ms, Ms, Ms, Ms, Ms, Ms, Ms, Ms, Ms, Ms
Aa, Aa^Fpa, Aa, Aa^Fpa, Rd, Aa^Fpa, Aa, Aa^Fpa, Ha^Fpa, Aa, Aa^Fpa, Aa^Fpa, Aa^Fpa, Aa^Fpa, Rd, Aa, Ms, Aa, Ms, Ms, Aa, Ha, Aa, Ha, Aa, Ha, Aa, Aa, Ai, Ai, Ai, Ai, Ai, Ai, Ms, Ms, Ms, Ms, Ha, Rd, Ha, Ha, Ms, Ms, Ms, Ms, Ms, Ms, Ms, Ms, Ms, Ms, Aa, Ms, Rd, Aa, Aa, Aa, Aa, Ms, Ms, Ms
Aa^Fpa, Aa^Fpa, Aa, Aa^Fpa, Rd, Aa^Fpa, Aa^Fpa, Aa^Fpa, Ha^Fpa, Aa^Fpa, Ha, Aa^Fpa, Ha, Ha, Ha, Rd, Aa, Ms, Ms, Ms, Aa, Aa, Aa, Aa, Aa, Aa, Ms, Ms, Ms, Ms, Ai, Ai, Ms, Ms, Ms, Ms, Ms, Ms, Ms, Rd, Rd, Rd, Rd, Ms, Ha, Ms, Aa, Ms, Ha, Ms, Aa, Aa^Voa, Aa, Aa, Aa, Aa, Rd, Aa, Aa, Aa, Aa, Ms
Aa, Aa^Fpa, Aa^Fpa, Ha^Fpa, Ha^Fpa, Rd, Ha^Fpa, Aa, Ha^Fpa, Ha^Fpa, Ha, Ha, Ms, Ms, Rd, Rd, Ms, Ms, Ms, Ms, Ms, Aa, Ms, Aa, Ms, Ms, Ms, Ms, Ms, Ms, Ms, Ms, Ms, Ms, Ms, Ms, Ms, Ms, Ms, Ms, Ms, Aa, Aa, Rd, Aa, Aa, Aa, Aa, Ha, Ha^Fpa, Ha^Fpa, Aa^Fpa, Aa^Fpa, Aa, Aa, Aa, Rd, Aa, Aa, Aa, Aa, Aa
Ha, Ha, Ha, Ha^Fpa, Ha, Rd, Rd, Ha, Ha, Ha, Ms, Ms, Rd, Rd, Ms, Ms, Ms, Ms, Ms, Ms, Ms, Ms, Ms, Ms, Ms, Ms, Ms, Ms, Ms, Ms, Ms, Ms, Ms, Ms, Ha^Voa, Aa, Ms, Ms, Ms, Ms, Ms, Ms, Ha, Rd, Aa^Fpa, Aa, Aa, Aa, Aa^Fpa, Ha^Fpa, Ha^Fpa, Aa^Fpa, Aa^Fpa, Aa, Aa, Coa, Rd, Coa, Aa, Aa, Aa, Aa
Aa, Ha, Ha, Ha, Ms, Ha, Aa, Rd, Ms, Ms, Ms, Ms, Rd, Ms, Ms, Ms, Ms, Ms, Coa, Ms, Ms, Ms, Ms, Ms, Aa, Ha, Aa, Ms, Rd, Ms, Ms, Ms, Aa, Aa, Aa, Aa, Aa, Chr, Chr, Aa, Aa, Ha, Aa, Rd, Aa, Aa, Aa, Aa, Aa, Aa^Fpa, Aa, Aa^Fpa, Aa, Aa, Rd, Rd, Aa, Aa, Aa, Aa^Voa, Aa, Aa
Aa, Ha, Ms, Ms, Ms, Ms, Ms, Rd, Rd, Ms, Aa, Aa, Rd, Ms, Ms, Ms, Coa, Coa, 4 Koa, Coa, Ms, Aa, Aa, Aa, Aa, Rd, Rd, Rd, Ms, Rd, Rd, Rd, Rd, Rd, Rd, Aa, Aa, Chr, Aa, Chr, Aa, Aa, Aa, Rd, Rd, Aa, Coa, Aa, Aa, Aa, Aa, Aa, Rd, Rd, Aa, Aa, Aa^Fpa, Aa, Aa, Aa, Ms, Ms
Ha, Ha, Ha, Ms, Ms, Ms, Ms, Ha, Ha, Rd, Rd, Aa, Rd, Ms, Ms, Ms, Rd, Coa, Ms, Coa, Ms, Ms, Ms, Ms, Ms, Aa, Ms, Ms, Ms, Ha, Ms, Ms, Ms, Ms, Aa, Rd, Rd, Aa, Aa, Aa, Aa, Aa, Aa, Aa, Coa, Coa, 5 Koa, Coa, Aa, Aa, Aa, Aa, Rd, Aa, Aa, Aa, Ms, Ms, Ms, Ms, Ms, Ms
Ha^Fpa, Ha, Ha^Fpa, Ms, Ms, Ms, Ms, Ms, Ms, Ha, Rd, Rd, Aa, Rd, Rd, Rd, Ms, Ms, Ms, Ms, Ms, Ms, Ms, Ms, Ms, Ms, Ms, Ms, Ms, Ms, Ms, Ms, Ms, Ms, Aa, Aa, Aa, Aa, Aa, Aa, Aa, Aa, Aa^Fpa, Aa, Aa, Coa, Coa, Rd, Rd, Aa, Rd, Rd, Aa^Fpa, Aa, Aa^Fpa, Ms, Ms, Ms, Ms, Ms, Ms, Ms
Ha^Fpa, Ha^Fpa, Ms, Ms, Ms, Ms, Ms, Ms, Aa, Rd, Aa, Ms, Ms, Ha^Voa, Ms, Ms, Ms, Ms, Ms, Ms, Ms, Ms, Ms, Ms, Aa, Ms, Ms, Ms, Ms, Ms, Ms, Ms, Ms, Aa, Aa, Aa, Aa, Aa, Ms, Ms, Ms, Aa, Aa, Aa, Aa, Coa, Aa, Aa, Aa, Rd, Ha^Voa, Aa, Aa, Aa, Ms, Ms, Ms, Ms, Ms, Ms, Ms, Ms
Ms, Ms, Ms, Ms, Ms, Ms, Aa, Aa, Rd, Rd, Ms, Ms, Ms, Ms, Ms, Ms, Ms, Ms, Aa, Ms, Ms, Ms, Ms, Ha^Voa, Ms, Ms, Ms, Ms, Ms, Ms, Ms, Ms, Ms, Ms, Ms, Ms, Ms, Ms, Ms, Ms, Ms, Ms, Ms, Ms, Ms, Aa, Ms, Ms, Ms, Ms, Ms, Ms, Ms, Ms, Ms, Ms, Ms, Ms, Ms, Ms, Ms, Ms
Ms, Ms, Ms, Ms, Ms, Ms, Ms, Aa, Rd, Ms, Ms, Ms, Ms, Ms, Ms, Ms, Ms, Ms, Aa, Ms, Ms, Ms, Ms, Aa, Ms, Ms, Ms, Ms, Ms, Ms, Ms, Ms, Ms, Ms, Ms, Ms, Ms, Ms, Ms, Ms, Ms, Ms, Ms, Ms, Ms, Ms, Ms, Ms, Ms, Ms, Ms, Ms, Ms, Ms, Ms, Ms, Ms, Ms, Ms, Ms, Ms, Ms
